The extent - степень, размер;
The permit - разрешать, допускать, разрешение, допуск, путёвка;
The goodwill - доброжелательность, благоговение;
The repute - репутация, известность, считать, полагать;
The reproduce - воспроизводить, размножаться;
The property - свойство, собственность, имущество, имущественный;
The foregoing - вышеупомянутый, предшествующий;
The forego - отказаться, воздержаться, предшествовать;
The fore - передний, носовой;
The gross - валовый, грубый;
The govern - регулировать, руководить, править, управлять, определять;
The lapse - промежуток, падение, ошибка, оплошность, упущение;
The clause - пункт, предложение, статья, условие, отговорка;
The reject - отбрасывать, отвергать, отклонять, отказывать, отказываться;
The configure - конфигурировать, настривать;
The settle - поселить, поселиться, обосновываться, оседать, улаживать, решать, разрешать, распологаться;
The spare - резервный, запасной, свободный, лишний, жалеть, щадить, экономить,  уделить;
The range - диапозон, дальность, круг, ряд, серия, область;
The fixture - приспособление;
The depreciate - недооценивать, обесценивать, обесцениваться, умолять;
The specification - спецификация, характеристика, определение, описание;
The lane - переулок, полоса, дорожка, ряд, аллея;
The trademark - торговый знак;
The arrow - стрела, стрелка;
The thereof - из них, этого;
The estate - имущество, имение, поместье, сословие;
The commerce - коммерция, торговля;
The presence - присутствиеЮ наличие;
The choppy - порывистый, изменчивый;
The framerate - частота кадров;
The seam - шов, пласт;
The enable - позовлять, включать, давать возможность;
The bar - бар, брусок, полоса, стержень;
The bold - смелый, дерзкий;
The crimson - малиновый;
The relive - пережить, возродиться;
The lay - рельеф, лежать, класть, прикладывть, мирской;
The layout - макет, схема, план, планировка, разметка, размещение, расположение;
The treat - удовольствие, угощение, лечить, трактовать, относиться, обращаться, обрабатывать;
The treatment - лечение, терапия, трактовка, уход, обработка, обращение;
The persist - сохраняться, оставаться, упорствовать;
The persistent - постоянный, настойчивый, устойчивый, упорный, стойкий;
The ampoule - ампула;
The serum - сыровотка;
The soothe - утешать, успокаивать;
The extract - экстракт, извлечение, выдержка, вытяжка, извлекать, добывать, экстрагировать;
The irritate - раздражать, нервировать;
The moisten - мочить, смочить, увлажнять;
The preserve - заповедник, сохранять, хранить, охранать, оберегать;
The resilient - упругий, эластичный, жизнерадостный;
The elastic - эластичный, упругий, гибкмй, резинка;
The restore - восстанвливать, реставрировать;
The complexion - цвет лица;
The cell - камера, клетка, элемент, ячейка;
The afterward - потом, позже, в последствии;
The supersonic - сверззвуковой, суперзвуковой;
The mask - маска, маскировать, скрывать;
The sufficient - достаточный;
The quantity - количество, величина;
The thorough - тщательной, полный, подробный, основательный, глубокий;
The absorb - поглощать, впитывать;
The moisturize - увлажнять;
The factor - фактор, коэффициент, множитель;
The buck - доллар, самец, противиться;
The delicate - деликатный, тонкий, нежный, изысканый, чувствительный, хрупкий;
The wrinkle - морщина, складка, морщить, сминаться;
The weave - ткать, плести, узор;
The strengthen - укреплять, укрепляться, усиливать;
The strength - сила, сопротивление, крепкость, прочночть, численность;
The stimulate - стимулировать, поощрять;
The balance - баланс, равновесие, остаток, весы, сталансировать, уравновешивать, балансовый;
The pore - пора;
The inflame - воспламенять, воспламеняться, возбуждать, распалять;
The flame - пламя, пылать;
The prevent - предупреждать, предотвращять, препятствовать, не допускать, мешать;
The premature - преждевременный;
The age - возраст, век, эпоха, период, взраслеть;
The percentage - процент, доля, часть, количество;
The immune - иммуный, невосприимчивый;
The tone - тон, тонус, оттенок, интонация;
The dehydrate - обезвоживать;
The wither - вянуть, увядать, сохнуть;
The lift - лифт, подъём, подъёмник, подъёмный, поднятияЮ поднимать;
The intense - интенсивный, сильный, напряжёнынй;
The rejuvenate - омолаживаться;
The exfoliate - расслаивать, расслаиваться;
The clarify - прояснить;
The caviar - икра;
The nourish - кормить, питать, удобрять, лелеять;
The carbon - уголь, углерод;
The demineralize - обессоливать, опреснять;
The fragrance - аромат, благоухание;
The alga - водоросль;
The drop - падение, перепад, понижение, снижение, капля, падать, понижаться, бросать, ронять, опускаться;
The lint - волокно, ворсинка;
The examine - исследовать, рассматривать, осматривать, обследовать, проверять;
The sensory - сенсорный, чувствительный;
The supervision - надзор, наблюдение;
The flow - поток, течение, течь, протекать;
The wipe - вытерать, протерать;
The mistreat - плохо обращаться;
The mutilate - калечить, уродовать, увечить, искажать;
The conduct - поведение, введение, проводить, вести;
The deviate - отклоняться, уклоняться, отступать;
The beam - луч, балка, брус, бревно, ширина;
The infrared - инфракрасный;
The emit - излучать, испускать, выделять, выпускать, выбрасывать;
The magnify - увеличивать, преувеличивать;
The pose - поза, позировать;
The reflect - оторожаться, отрожать, отображать, размышлять;
The stabilize - стабилизировать, стабилизироваться;
The associate - ассоциировать, ассоциироваться, общаться, связывать;
The tendon - сухожилие;
The numb - онемевший, оцепенелый;
The swell - зыбь, разбухание, разбухать, раздуваться, опухать, вал, выпуклость, шикарный;
The cramp - мешать, стеснять, спазм, судорога, скоба, зажим, колики, резь;
The stiff - жёсткий, тугой;
The foreseeable - предсказуемый;
The occupy - окпировать, занимать;
The damp - влажный, сырой, влажность, сырость;
The cloth - ткань, скатерть, полотно;
The exterior - экстерьер, внешность, внешний, наружный;
The cleanser - моющее средство;
The preliminary - предварительный;
The appearance - появление, явление, вид, видимость, внешность, выступление;
The tray - лоток, поддон, поднос;
The dual - двойной, двойственный;
The sustain - поддерживать, выдерживать;
The reuse - повторное использование;
The attempt - попытка, покушение, опыт, пытаться;
The petrol - бензин, бензиновый;
The atmosphere - атмосфера, обстановка, воздух;
The sphere - сфера, шар;
The deck - палуба, палубный, колода, настил;
The boat - лодка, шлюпка, корабль, судно;
The grain - зерно, зернистость;
The powder - порох, порошок, пудра;
The pacemaker - кардиостимулятор, лидер;
The pace - шаг, шагать, расхаживать, темп, скорость;
The breast - грудь, молочные железы;
The opposite - напротив, против, противоположенность, противоположенный, обратный;
The aid - помощь, поддержка, помощник, помогать, способствовать;
The cochlea - улитка;
The implant - внедрять, вживлять, насаждать;
The traffic - движение, транспорт, перевозки, торговля;
The conform - соответствовать, подчиняться;
The obey - подчиняться, повиноваться, слушаться;
The employ - использовать, принимать, употреблять, нанимать;
The correspond - соответствовать, переписываться;
The inquire - спрашивать, исследовать;
The courtesy - вежливость, учтивость, обходительность;
The pop - хлопнуть, эстрадный;
The pop up - неожиданно возникнуть;
The rout - поражение, разгром, разгромить;
The wire - провод, проволока, проволочный;
The browse - просматривать, пролистывать;
The log - журнал, бревно;
The line - линия, строка, направление, черта, ряд;
The conflict - конфликт, столкновение, противоречие, противоречить;
The bind - вязать, связывать, пивязывать;
The binding - обязательный, переплёт, связь;
The province - провиция, область;
The indeed - на самом деле, действительно;
The convey - передавать, транспортировать, сообщать, выражать;
The suspend - приостонавливать;
The invite - приглашать, привлекать, просить, приглашение;
The host - множество, хозяиин, ведущий, войско;
The notwithstanding - не смотря на, вопреки;
The prohibit - запрещать, препятствовать;
The stipulate - оговаривать;
The affix - ставить, приложить, прикреплять;
The strike - удар, забастовка, бить, бастовать;
The tornado - торнадо, ураган, смерч, вихрь, шквал;
The employee - работник, служащий;
The enforce - навязывать;
The enforceability - исполнимость;
The duly - должным образом, правильно;
The cam - кулак, кулачок, эксцентрик;
The spring - весна, весенний, возникать, родник, источник;
The tweezers - пинцет, щипчики;
The recess - углубление, выемка, впадина, паз, прорези, каникулы, ниша;
The inward - внутрь, внутренний, внутренности;
The fuse - пробка, предохранитель, взрыватель, фитиль, запал, сливаться, плавить;
The refuse - мусор, отходы, отбросы, отказывать, отказываться;
The assert - заявлять, утверждать, отстаивать;
The shave - брить, бриться, бритьё;
The foil - фольга;
The excess - излишек, избыток, лишний, избыточный, превышение;
The stress - стресс, напряжение, давление, усилие, ударение, акцент, чёткость;
The handover - передача, сдавать;
The notify - извещать, уведомлять;
The plant - растение, фабрика, завод, установка, оборудование, сажать, насаждать;
The identical - идентичный, одинаковый;
The reimburse - возвращать, возмещать;
The rescind - отменять, аннулировать;
The justify - оправдывать;
The justification - оправдание, выравнивание;
The accrue - нарастить, накапливаться, доставаться;
The accrued - начисленный;
The hypothetical - гипотетический;
The interest - интерес, заинтересованность, интересовать,, заинтересовывать, доля, процент;
The forward - вперёд, дальше, пересылать, передний, передовой, нападающий;
The clippers - машинка для стрижки, ножницы;
The clip - клип, клипс, зажим, скрепка, скоба, обрезать, отсекать;
The fur - мех, шерсть, меховой, пушной;
The subsequent - последующий;
The suffocate - задызаться, душить, удушать;
The tub - ванна, кадка, бак;
The residue - остаток, осадок;
The kink - чудить, перекручивать, изгиб, заскок, петля, перекручивание;
The spray - спрей, брызги, распылитель, опрыскивать, разбрызгивать, распылять;
The prolong - продлить, продолжать, пролонгировать;
The blade - лезвие, лопость, клинок, диск, полотно;
The insulate - изолировать, изолированный;
The comb - гребень, гребешёк, расчёска, расчёсывать, прочёсывать, пчилиные соты;
The brush - кисть, щётка;
The scissors - ножницы;
The torque - крутящий момент;
The fluctuate - колебаться,  меняться;
The clockwise - по часовой стрелке;
The position - позиция, место, местополложение, расположение, положение, должность;
The dampen - увлажнять, затушить;
The solvent - растворитель, платёжеспособный;
The align - выравнивать;
The gap - разрыв, зазор, щель, интервал, пробел, промежуток, отставание, дефицит, брешь;
The hassle - стычка, перебранка;
The toggle - переключать, переключать, тумблер;
The enhance - усиливать, увеличивать, повышать, совершенствовать;
The alternate - чередовать, чередоваться, чередующийся, переменный, дополнительный, заместитель; 
The regular - регулярный, очередной, обычной, официальный, првильный, постоянный;
The cause - повод, причина, дело, вызывать;
The discard - отказаться, отвергать, отбрасывать, сбрасывать, выбрасывать;
The bin - мусорное ведро, ящик, бункер;
The diverge - расходиться,  отклоняться;
The motion - движение, ход, ходотайство, предложение, перемещение;
The unite - объеденять, объеденяться, соединять, соединяться, сплотиться;
The recover - восстонавливать, выздоравливать, оправляться;
The recovery - восстановление, выздаровление, оздоровление, возмещение, возврат, извлечение, добыча, утилизация;
The particle - частица;
The emergency - аварийный, экстренный, непредвиденный;
The necessitate - требовать, вынуждать;
The incorporate - объединать, включать;
The depict - изображать, рисовать, описывать;
The scope - рамки, границы, размах, масштаб, простор, возможности, сфера, сфера действия, область видимости;
The constitute - составлять;
The conspicuous - заметный, бросающийся в глаза;
The absent - отсутствовать, отсутствоующий, в отсутствии;
The prominent - известный, видный, выдающийся;
The derive - получать, происходить, извлекать, выводить;
The aggregate - совокупный, агрегатный, общий, совокупность, агрегат, заполнитель, объединять, агрегировать;
The nominal - номинальный, именной, условный;
The stand - стенд, стойка, подставка, позиция, киоск, трибуны, стоять, устоять, находиться, терпеть, баллотироваться;
The compensate - компенсировать, возмещать;
The rightward - вправо;
The plate - тарелка, плита, пластинка, лист;
The splash - всплеск, плеск, брызги, плескаться, брызгать;
The detergent - моющее средство, моющий;
The corrode - ржаветь, разъедать;
The tissue - ткань;
The overwhelm - сокрушать, заваливать, подавлять, ошеломлять;
The volume - объём, объёмный, том, громкость;
The lid - крышка, покрышка. веко;
The jack - гнездо, разетка, домкрат;
The proximity - близость;
The slate - шифер, список кандидатов;
The needle - игла, игольчатый;
The hole - отверстие, скважина, дыра, лунка, яма;
The idle - холостой, простой, праздный, пустой, неработающий;
The tap - кран, отвод, ответвление;
The drag - тянуть, тащить, бремя, торможение;
The context - контекст, ситуация, обстановка;
The elapse - проходить;
The nail - коготь, ноготь, гвоздь, прибивать;
The thumbnail - эскиз, набросок, зарисовка;
The fold - сгиб, складка, складывать;
The administrate - контролировать, управлять;
The consistent - последовательный;
The aim - цель, прицеливание, стремиться, целиться;
The constant - постоянный, константа;
The swipe - красть, коромысло, сильный удар;
The among - среди, между, в числе, из, у;
The ordinary - обычный, обыкновенный, простой;
The customary - обычный, привычный;
The induce - вызывать, стимулировать, побуждать;
The contest - конкурс, соревнование, состязание, оспаривать;
The swap - обмен, обмеиваться, менять;
The tip - чаевые, наконечник, кончик, конец, вершина, верхушка, совет;
The letter - письмо, послание, буква, символ;
The bring - приносить, приводить, доводить;
The bring up - воспитывать, растить, поднимать, подвезти;
The standby - резрвный;
The backup - резервный, резервная копия, резервирование;
The integrity - честность, целостность, неприкосновенность;
The implement - осуществлять, выполнять, орудие;
The practice - практика, тренировка, опыт, тренировать, тренироваться, заниматься;
The generous - щедрый, великодушный, обильный, большой, благородный;
The reliant - уверенный;
The reliance - уверенность, доверие, надежда, опора;
The explicit - явный;
The revise - пересматривать, справлять, проверка, сверка;
The distinguish - различать, отличать, выделять, распозновать;
The assume - предпологать, принимать;
The agreed - согласованный;
The interchange - обмен, обмениваться, смена, черидование;
The script - сценарий, подлинник;
The execute - выполнять, осуществлять, казнить, исполнять;
The compel - принуждать, вынуждать, заставлять;
The terminate - завершать;
The court - суд, корт, площадка, двор, ухаживать;
The allegation - заявление, голословное утверждение;
The legation - дипломатическая миссия, откомандирование посла;
The fringe - бахрама, чёлка, карма, окраина;
The infringe - нарушать, ущемлять, посягать;
The contradict - противоречить, возражать;
The satisfy - удовлетворять;
The pertinent - уместный, подходящий;
The refrain - воздержаться, рефрен, припев;
The verbatim - дословно, слово в слово;
The preamble - вступление;
The whose - чей;
The commit - совершать, фиксировать;
The forbid - запрещать;
The deny - отрицать, отказывать, отвергать;
The surrender - отказ, сдача, капитуляция, сдавать, сдаваться, капитулировать;
The gratis - бесплано, даром;
The recipient - получатель;
The threaten - угрожать, грозить;
The patent - патент, патентовать, патентный;
The redistribute - перераспределять;
The individual - индивидуальный, отдельный, человек, личность, индивидуум, особь;
The derivative - производный;
The hereinafter - в дальнейшем, ниже;
The address - адрес, адресовать, ссылаться;
The activity - активность, деятельность;
The thus - таким образом, поэтому, так;
The kernel - ядро, зерно;
The exercise - упражнение, учение, занятие, тренировка, осуществление, осуществлять, тренироваться, проявлять, выполнять;
The excuse - оправдание, отговорка. предлог, извенение, служить оправданием;
The licensee - лицо имющее разрешение;
The hold - захват, занимать, держать, держаться, удерживать, проводить, вести, владение, иметь, трюм;
The mail - почта, почтовый;
The absolute - абсолютный, полный, безусловный;
The whatever - любой, какой-бы ни, что-бы ни;
The compile - компилировать, составлять, собирать;
The valve - клапан, вентиль, заслонка;
The cap - калпочок, крышка, кепка, шапка, фуражка, цоколь, заглужка, наконечник;
The inflate - надувать, надуваться, накачивать, взвинчивать;
The compress - копресс, сжимать, сдавливать;
The deflate - спускать, снижать, выкачивать, выпускать воздух;
The trim - отделка, аккуратный, подстрегать, подрезать;
The latch - защёлка, задвижка, запор;
The shift - сдвиг, смена, изменение, переключение, перемещение;
The scale - масштаб, шкала, размер, гамма;
The slope - наклон, склон, уклон, откос, скат, крутизна;
The puncture - пробой, прокол, укол, прокалывать;
The senior - старший;
The tailor - портной;
The stain - пятно, окрашивать, пачкать;
The alloy - сплав;
The shear - сдвиг, срез, срезать, ножницы;
The smear - пятно, мазок, мазать, клевета;
The vegetable - овощ, овощной, растительный;
The brake - тормоз, тормозной, тормозить;
The mechanic - механик, механический, слесарь;
The pad - блокнот, подушка, подкладка;
The squarely - прямо;
The rim - обод, ободок, оправа, край;
The washer - стиральная машинка, шайба;
The sequent - следующий, последовательный;
The clearance - ззазор, просвет, отчистка, разрешение;
The toe - палец, носок;
The grip - ручка, рукоятка, хватка, захват, захватывать, зажим, зажатие, контроль, власть;
The density - плотность;
The dimension - измерение, размер, размерность;
The foam - пена, пениться;
The chop - нарезать, крушить, рубить, отбивная;
The comfy - удобный, уютный, комфортабельный;
The slip - листок, скольжение, скользить, ускользнуть, подсунуть, промах;
The coat - пальто, пиджак, слой, оболочка, шерсть, покрывать;
The whisk - взбивать, смахивать;
The shaft - вал, ствол, стержень, ось, шахта;
The tare - тара;
The compartment - отдел, отделение, купе;
The bowl - чаша, шар, миска, ваза;
The polar - полярный, полюсный;
The isolate - изолировать, выделять;
The equal - равный, ровняться;
The inscription - надпись;
The repeat - повторять, повторяться, повторение, повторный;
The relocate - перемещать, переселять, передислоцировать;
The bill - вексел, банкнота, счёт, законороект, клюв;
The council - совет;
The chase - преследовать, гнаться, выгонять, преследование, погоня, охота;
The undertake - предприниматься, браться;
The enlist - вербовать, заручаться поддержкой;
The coupon - купон, талон;
The legible - чёткий, разборчивый;
The contradictory - противоречащий, противоречивый;
The structure - структура, структуировать, строение, сооружение, здание, конструкция, устройство;
The whereby - посредством чего;
The accumulate - накапливать, накапливаться, аккумулировать;
The belt - ремень, пояс;
The grid - сетка, решётка;
The flask - колба, склянка, фляга, флакон;
The rack - стойка, стилаж, полка, подставка, рама, вешалка, мучить;
The roast - жарить, жариться, жаркое, жаренный;
The tube - метро, труба, трубка, тюбик, лампа;
The odor - запах, аромат, благоухание;
The adsorb - поглащать;
The violate - нарушать;
The crumple - мять, мяться, морщиться, комкать, рухнуть, падать духом, сваливаться, съёживаться, закручивать, сгибать, мятая складка;
The rupture - разрыв, прорыв;
The mesh - сеть;
The legislate - ззаконодательствовать, издавать законы;
The incandenscent - наколённый, расколённый, сверкающий;
The bulb - лампа, луковица, колба, баллон, шарик;
The span - охватывать, диапозон, пролёт, интервал;
The soleplate - подошва;
The variable - переменная;
The iron - железо, железный, утюг, гладить;
The drip - капать, стекать;
The swivel - поворотный, вращающийся;
The occasion - случай, событие, повод, возможность, раз;
The impedance - сопративление;
The membrane - мембрана, перепонка, плёнка, оболочка;
The stew - тушить, тушиться, тушоное мясо, вариться;
The porridge - каша;
The spoon - сложка;
The pulse - пульс, импульс, пульсировать;
The dough - тесто, паста;
The funnel - воронка;
The chip - обломок, стружка, микросхема, фишка, биться;
The reverse - обратный, противоположенное, задний ход;
The reversible - двусторонний, обратимый, реверсивный;
The slice - ломтик, часть, нарезать;
The suction - всасывание, всасывающий;
The suck - сосасть, всасыввать, высасывать;
The salubrious - целебный, здоровый;
The mount - устанавливать, монтировать, гора;
The harvest - уражай, жатва, сбор, плоды, собирать урожай;
The bud - бутон, почка, приятель;
The ruby - руби, рубиновый;
The blend - смесь, смешение, смешивать, смешиваться, гармонировать;
The bean - фасоль, боб;
The nuance - нюанс, оттенок;
The amongst - среди, между, в числе, из, у;
The overload - перегрузка, перегружать;
The complaint - жалоба, недовольство;
The clutter - беспорядок, шум, хаос;
The fume - дым, пар, дымить;
The bystander - свидетиль, наблюдатель;
The distract - отвлекать;
The pipe - труба, трубопровод;
The edge - карй, кромка, грань, ребро, лезвие, острие, преимущество;
The entangle - вовлекать, впутывать, спутывать, запутывать;
The conjunction - соединение, совпадение, стечение, соединение, союз, связь, конъюнкция;
The alert - тревога, бдительный;
The hard hat - каска;
The skid - занос, заносить, скользить;
The overreach - перехитрить, достигать мошенническим путём;
The loose - свободно, свободный, рыхлый, сыпучий, развязывать;
The jewelry - ювелирный, брагоценности;
The glove - перчатка;
The clamp - зажим, зажимать, скоба, хамут;
The standstill - застой, затишье, бездействие;
The terminal - терминал, вокзал, клемма, кольцевой;
The eject - выбрасывать, изгонять;
The flush - румянец, краска, промывать;
The seek - искать, просить, пытаться, стремиться, добиваться, обращаться;
The engineer - инжинер, механик, проектировать;
The epilate - удалать волосы;
The gentle - нежный, мягкий, добрый, вежливый, ласковый, лёгкий, кроткий, пологий, тихий;
The arrange - договариваться, устраивать, распологать, арранжировать;
The integrate - интегрировать, оюъединять;
The stubble - щетина;
The wet - мокрый, влажный, сырой, мочить, смочить, увлажнять;
The lash - плеть, порка, ремень, ресница, хлестать, стегать;
The ribbon - лента, ленточный;
The transform - трансформировать, преобразовывать, переводить;
The forearm - предплечье;
The underarm - снизу, подмышка;
The leg - нога, стойка, этап, ветвь;
The itch - зуд, честока, жажда, зудеть, испытывать зуд, чесаться;
The redden - краснеть, покраснение;
The physician - доктор, врач, медик, лекарь, терапевт;
The tend - иметь тенденцию;
The diminish - ослаблять, уменьшаться, уменьшать;
The follicle - фоликул, стручок, мешочек, листовка;
The purulent - гнойный;
The mole - мол, моль, крот, родинка;
The deficient - недостающий, недостаточный, несовершенный;
The cream - крем, кремовый, сливки;
The sponge - губка;
The peel - чистить, отчищать, кожура, кожица, корма, шелуха;
The scrub - скраб, кустарник, тереть, скрести;
The grease - смазка, смазывать, жир;
The stretch - растягивать, растягиваться, простираться, тянуться, вытягивание, растягивание, простирание, протяжение, натяжка;
The dab - прикоснавение, пятно, тыкать, намазывать, мастер, знаток;
The towel - полотенце;
The commence - начинать, начинаться;
The eliminate - устронять, ликвидировать, исключать;
The appoint - назначать;
The construe - истолковать;
The forth - вперёд, дальше;
The subsidiary - вспомогательный;
The recur - повторяться;
The engage - заниматься, привлекать, вовлекать, впутывать;
The expend - тратить, раскодовать;